ğŸ˜€_grinning_face	seem good
ğŸ˜_beaming_face_with_smiling_eyes	very good
ğŸ˜‚_face_with_tears_of_joy	hugely good
ğŸ˜ƒ_grinning_face_with_big_eyes	hugely good
ğŸ˜„_grinning_face_with_smiling_eyes	very good
ğŸ˜…_grinning_face_with_sweat	very good
ğŸ˜†_grinning_squinting_face	hugely good
ğŸ˜‰_winking_face	very good
ğŸ˜Š_smiling_face_with_smiling_eyes	good
ğŸ˜‹_face_savoring_food	very good
ğŸ˜_smiling_face_with_sunglasses	good
ğŸ˜_smiling_face_with_heart-eyes	good
ğŸ˜˜_face_blowing_a_kiss	very good
ğŸ˜—_kissing_face	hugely good
ğŸ˜™_kissing_face_with_smiling_eyes	hugely good
ğŸ˜š_kissing_face_with_closed_eyes	very good
â˜º_smiling_face	good
ğŸ™‚_slightly_smiling_face	good
ğŸ¤—_hugging_face	good
ğŸ¤”_thinking_face	just good
ğŸ˜_neutral_face	just neutral
ğŸ˜‘_expressionless_face	seem bad
ğŸ˜¶_face_without_mouth	neutral
ğŸ™„_face_with_rolling_eyes	neutral
ğŸ˜_smirking_face	neutral
ğŸ˜£_persevering_face	very bad
ğŸ˜¥_sad_but_relieved_face	very bad
ğŸ˜®_face_with_open_mouth	neutral
ğŸ¤_zipper-mouth_face	bad
ğŸ˜¯_hushed_face	neutral
ğŸ˜ª_sleepy_face	neutral
ğŸ˜«_tired_face	bad
ğŸ˜´_sleeping_face	neutral
ğŸ˜Œ_relieved_face	neutral
ğŸ˜›_face_with_tongue	good
ğŸ˜œ_winking_face_with_tongue	seem good
ğŸ˜_squinting_face_with_tongue	seem good
ğŸ˜’_unamused_face	seem bad
ğŸ˜“_downcast_face_with_sweat	seem bad
ğŸ˜”_pensive_face	bad
ğŸ˜•_confused_face	bad
ğŸ™ƒ_upside-down_face	neutral
ğŸ¤‘_money-mouth_face	good
ğŸ˜²_astonished_face	bad
â˜¹_frowning_face	seem bad
ğŸ™_slightly_frowning_face	seem bad
ğŸ˜–_confounded_face	neutral
ğŸ˜_disappointed_face	very bad
ğŸ˜Ÿ_worried_face	very bad
ğŸ˜¤_face_with_steam_from_nose	very bad
ğŸ˜¢_crying_face	bad
ğŸ˜­_loudly_crying_face	very bad
ğŸ˜¦_frowning_face_with_open_mouth	neutral
ğŸ˜§_anguished_face	bad
ğŸ˜¨_fearful_face	seem bad
ğŸ˜©_weary_face	seem bad
ğŸ˜¬_grimacing_face	seem bad
ğŸ˜°_anxious_face_with_sweat	neutral
ğŸ˜±_face_screaming_in_fear	neutral
ğŸ˜³_flushed_face	neutral
ğŸ˜µ_dizzy_face	neutral
ğŸ˜¡_pouting_face	bad
ğŸ˜ _angry_face	very bad
ğŸ˜·_face_with_medical_mask	good
ğŸ¤’_face_with_thermometer	very bad
ğŸ¤•_face_with_head-bandage	bad
ğŸ˜‡_smiling_face_with_halo	seem good
